NO ./includes/textures/emptywall.xpm
SO ./includes/textures/wallbluearcade.xpm
WE ./includes/textures/emptywall.xpm
EA ./includes/textures/emptywall.xpm

F 40, 40, 65
C 0, 0, 50

111111111111111111
100000000000000001
100000000000000001
100000000000000001
100000000000000001
100000000000000001
100000000000000001
100000000000000001
1000000000000000001
10000000N0000000011
10000000000000000001
1111111111111111111
